. . C . .
@ . . . .
. @ . @ .
. . . . @
. . W . .