. . C . . . C . .
. . . . . . . . .
. . . . . . . . .
. @ . @ . . @ . .
. . . . . . . . .
. . @ . . @ . @ .
. . . . . . . . .
. . . . . . . . .
. . W . . . W . .